; NOTE: don't use \", use ' instead
; NOTE: don't use #, use ; instead for comments
; NOTE: leave the [strings] alone

; MIGRATE RESOURCES

MigrateTitle=Code First Migrations Command Line Utility
MigrateDescription=Applies any pending migrations to the database.

ErrorMessage=ERROR: {0}
WarningMessage=WARNING: {0}
VerboseMessage=VERBOSE: {0}

DuplicateCommand=Duplicate Command "{0}"
DuplicateParameterIndex=Duplicate Parameter Index [{0}] on Property "{1}"
ParameterOutOfOrder=Out of order parameter "{0}" should have be at parameter index {1} but was found at {2}
InvalidKey="{0}" is not a valid choice, valid keys are "{1}"
PressAnyKey=Press any key to continue...
UnsupportedPropertyType=Unsupported property type {0}
InvalidPropertyParameterIndexValue=Invalid ParameterIndex value on property "{0}"

; Argument descriptions

AssemblyNameArgument=assembly
ConfigurationTypeNameArgument=configurationType
AssemblyNameDescription=Specifies the name of the assembly that contains the migrations configuration type.
ConfigurationTypeNameDescription=Specifies the name of the migrations configuration type. If omitted, Code First Migrations will attempt to locate a single migrations configuration type in the specified assembly.
TargetMigrationDescription=Specifies the name of a particular migration to update the database to. If omitted, the current model will be used.
WorkingDirectoryDescription=Specifies the working directory of your application.
ConfigurationFileDescription=Specifies the Web.config or App.config file of your application.
DataDirectoryDescription=Specifies the directory to use when resolving connection strings containing the |DataDirectory| substitution string.
ConnectionStringNameDescription=Specifies the name of the connection string to use from the specified configuration file. If omitted, the context's default connection will be used.
ConnectionStringDescription=Specifies the the connection string to use. If omitted, the context's default connection will be used.
ConnectionProviderNameDescription=Specifies the provider invariant name of the connection string.
ForceDescription=Indicates that automatic migrations which might incur data loss should be allowed.
VerboseDescription=Indicates that the executing SQL and additional diagnostic information should be output to the console window.
HelpDescription=Display this help message.

; Exceptions

## ExceptionType=InvalidOperationException
AmbiguousAttributeValues=Only one of '{0}' and '{1}' can be assigned to.

## ExceptionType=CmdLine.CommandLineException
AmbiguousConnectionString=Only one of /connectionStringName or /connectionString can be specified.

## ExceptionType=CmdLine.CommandLineException
MissingConnectionInfo=/connectionString and /connectionProviderName must be specified together.

## ExceptionType=CmdLine.CommandLineException
InvalidParameterIndexValue=Invalid ParameterIndex value
